00000000000000000
00000000000000000
0    0000000    0
0    0000000    0
0               0
0               0
0               0
000             0
000             0
00             00
00000000000000000